"Gemeenten";"Bevolking totaal";"Bevolking totaal vrouwen";"Bevolkingsdichtheid";"Bevolking totaal mannen";"Gemiddelde leeftijd bevolking";"Gemiddelde leeftijd mannen";"Gemiddelde leeftijd vrouwen";"Bevolking leeftijd -4 jaar";"Totaalscore Leefbaarometer 2.0 (label)"
"Aa en Hunze";25286;12683;91;12603;46,5;45,3;47,6;936;8
"Aalburg";13067;6452;246;6615;39,6;38,7;40,6;793;7
"Aalsmeer";31373;15857;972;15516;41,3;40,6;42,0;1607;6
"Aalten";27047;13422;279;13625;43,5;42,3;44,7;1230;7
"Achtkarspelen";27893;13708;268;14185;41,3;40,3;42,3;1482;6
"Alblasserdam";20008;10199;1989;9809;40,5;39,4;41,6;1273;6
"Albrandswaard";25105;12655;1057;12450;41,1;40,3;41,8;1369;7
"Alkmaar";108373;54714;924;53659;41,8;40,8;42,8;5664;7
"Almelo";72479;36314;1044;36165;41,7;40,7;42,7;3596;6
"Almere";200914;101241;808;99673;37,5;37,0;37,9;12224;6
"Alphen aan den Rijn";108915;54751;822;54164;41,3;40,6;42,0;5736;7
"Alphen-Chaam";10058;4937;108;5121;44,1;43,5;44,7;451;8
"Ameland";3633;1834;14;1799;43,6;42,6;44,6;179;6
"Amersfoort";154337;78394;2417;75943;39,0;38,0;39,9;9243;7
"Amstelveen";89294;46555;2026;42739;41,4;40,0;42,8;5280;7
"Amsterdam";844947;426820;3850;418127;38,1;37,8;38,4;47380;6
"Apeldoorn";160047;80556;469;79491;42,7;41,5;43,9;7924;7
"Appingedam";11971;6169;487;5802;44,9;43,6;46,2;537;6
"Arnhem";155699;77992;1533;77707;39,4;38,6;40,3;8581;6
"Assen";67551;34183;809;33368;42,0;40,7;43,2;3324;8
"Asten";16714;8110;234;8604;43,2;42,3;44,2;703;7
"Baarle-Nassau";6657;3276;87;3381;46,5;45,7;47,4;282;7
"Baarn";24529;12691;743;11838;44,4;42,9;45,9;1204;8
"Barendrecht";48344;24484;2225;23860;40,2;39,5;41,0;2752;7
"Barneveld";56376;28320;319;28056;38,1;37,1;39,0;4097;8
"Bedum";10479;5238;233;5241;43,1;42,2;44,0;531;8
"Beek";15951;8149;758;7802;46,2;45,5;46,8;603;7
"Beemster";9205;4625;128;4580;43,1;42,6;43,5;493;8
"Beesel";13405;6637;460;6768;44,5;43,4;45,6;545;7
"Bellingwedde";8919;4385;81;4534;47,5;46,5;48,5;321;6
"Berg en Dal";34764;17461;373;17303;45,3;44,1;46,5;1397;8
"Bergeijk";18342;9003;180;9339;43,7;43,0;44,3;787;7
"Bergen (L.)";13095;6563;121;6532;44,9;44,6;45,2;519;6
"Bergen (NH.)";29844;15459;248;14385;48,9;47,7;50,0;874;8
"Bergen op Zoom";66164;33419;710;32745;43,3;42,4;44,2;3169;6
"Berkelland";44238;22014;170;22224;44,7;43,7;45,7;1755;7
"Bernheze";30252;14994;335;15258;42,4;41,7;43,2;1375;7
"Best";29180;14567;831;14613;42,2;41,6;42,7;1344;7
"Beuningen";25424;12727;540;12697;42,8;42,0;43,5;1144;7
"Beverwijk";40709;20387;2026;20322;41,3;40,2;42,4;2195;6
"Binnenmaas";29122;14683;385;14439;44,0;43,2;44,7;1352;7
"Bladel";20063;9886;265;10177;43,0;42,2;43,9;946;7
"Blaricum";10201;5238;656;4963;45,1;44,0;46,2;552;8
"Bloemendaal";22826;11841;505;10985;45,6;44,1;47,1;969;9
"Bodegraven-Reeuwijk";33733;16832;381;16901;41,4;40,5;42,3;1870;7
"Boekel";10414;5088;302;5326;41,1;40,8;41,5;507;7
"Borger-Odoorn";25355;12709;91;12646;45,4;44,7;46,1;996;7
"Borne";22795;11384;871;11411;42,4;41,5;43,4;1261;8
"Borsele";22688;11217;117;11471;42,0;41,3;42,7;1213;7
"Boxmeer";28709;14240;252;14469;44,1;43,0;45,1;1095;7
"Boxtel";30655;15424;473;15231;42,9;42,1;43,6;1357;7
"Breda";182304;92710;1417;89594;40,8;39,9;41,6;9232;6
"Brielle";16833;8573;541;8260;44,2;43,4;45,0;746;6
"Bronckhorst";36410;18260;127;18150;45,8;45,1;46,6;1277;8
"Brummen";20843;10561;245;10282;45,3;44,3;46,3;828;8
"Brunssum";28358;14485;1635;13873;45,7;44,4;47,1;1077;7
"Bunnik";15156;7651;403;7505;43,2;42,0;44,5;836;8
"Bunschoten";21020;10527;604;10493;38,5;38,0;39,0;1327;7
"Buren";26348;13136;184;13212;42,5;41,9;43,2;1252;7
"Capelle aan den IJssel";66421;34341;4313;32080;42,0;40,8;43,2;3668;6
"Castricum";35216;17962;583;17254;44,9;43,9;45,8;1491;8
"Coevorden";35286;17692;118;17594;44,6;43,5;45,7;1545;7
"Cranendonck";20676;10272;265;10404;44,3;43,3;45,3;936;8
"Cromstrijen";12797;6452;182;6345;44,5;43,7;45,3;541;7
"Cuijk";24696;12386;433;12310;43,0;42,2;43,7;1180;6
"Culemborg";27864;14003;895;13861;41,3;40,2;42,3;1405;6
"Dalfsen";28070;13850;169;14220;42,3;41,6;43,0;1496;8
"Dantumadiel";18942;9406;216;9536;42,7;41,8;43,7;952;7
"De Bilt";42754;22320;637;20434;44,4;42,7;46,0;2086;7
"De Fryske Marren";51585;25597;94;25988;43,2;42,4;44,1;2442;7
"De Marne";10088;4988;42;5100;44,8;44,6;45,1;456;6
"De Ronde Venen";42763;21619;366;21144;43,2;42,4;44,0;1863;6
"De Wolden";23744;11891;105;11853;44,6;43,8;45,5;1049;8
"Delft";101381;47386;4214;53995;39,1;37,5;40,9;4539;6
"Delfzijl";24965;12405;110;12560;45,5;44,6;46,4;1029;6
"Den Haag";524882;265045;5349;259837;38,9;38,2;39,7;32275;6
"Den Helder";56020;28270;313;27750;43,8;42,7;44,8;2638;6
"Deurne";31933;15862;270;16071;43,2;42,3;44,1;1563;7
"Deventer";99295;50231;739;49064;40,9;40,0;41,8;5275;6
"Diemen";27272;14021;1942;13251;39,8;39,2;40,4;1441;6
"Dinkelland";26244;12832;148;13412;43,0;41,8;44,1;1111;8
"Doesburg";11341;5797;875;5544;44,8;43,9;45,6;418;6
"Doetinchem";57068;28809;716;28259;42,8;41,9;43,7;2776;7
"Dongen";25509;12780;858;12729;43,0;42,0;44,1;1149;7
"Dongeradeel";23901;11954;90;11947;42,5;41,8;43,2;1208;6
"Dordrecht";118731;60047;1194;58684;41,6;40,7;42,5;6260;6
"Drechterland";19384;9549;241;9835;42,4;41,9;42,9;942;7
"Drimmelen";26869;13397;225;13472;44,0;43,2;44,7;1139;7
"Dronten";40746;20244;96;20502;40,5;39,8;41,3;2006;7
"Druten";18563;9318;437;9245;42,2;41,3;43,1;793;7
"Duiven";25398;12870;722;12528;42,4;41,5;43,2;1078;8
"Echt-Susteren";31815;15818;304;15997;46,3;45,2;47,3;1201;8
"Edam-Volendam";35800;17889;448;17911;42,0;41,4;42,6;1662;7
"Ede";113421;57507;356;55914;40,2;39,4;41,1;6669;8
"Eemnes";8999;4565;267;4434;42,8;42,3;43,3;406;8
"Eemsmond";15656;7682;29;7974;44,1;43,4;44,8;681;7
"Eersel";18554;9143;223;9411;44,0;43,1;44,9;860;7
"Eijsden-Margraten";25297;12703;323;12594;45,4;44,9;45,9;1060;9
"Eindhoven";226868;110561;2553;116307;40,3;39,2;41,5;11014;6
"Elburg";23026;11558;349;11468;40,5;39,4;41,6;1426;7
"Emmen";107490;54029;310;53461;43,8;42,8;44,9;4688;7
"Enkhuizen";18479;9185;159;9294;42,7;41,5;43,8;930;6
"Enschede";158140;77652;1108;80488;40,3;39,1;41,5;7728;7
"Epe";32537;16406;207;16131;45,0;43,7;46,3;1431;8
"Ermelo";26590;13412;304;13178;43,8;42,5;45,0;1185;7
"Etten-Leur";43027;21784;769;21243;42,1;41,4;42,8;2176;7
"Ferwerderadiel";8735;4262;66;4473;41,7;41,1;42,4;508;7
"Franekeradeel";20215;10048;185;10167;43,3;42,7;43,9;933;6
"Geertruidenberg";21504;10810;726;10694;42,7;42,0;43,4;1088;6
"Geldermalsen";26587;13408;261;13179;41,6;40,6;42,6;1350;6
"Geldrop-Mierlo";39078;19710;1245;19368;43,3;42,3;44,4;1897;7
"Gemert-Bakel";30024;14852;243;15172;41,9;41,5;42,3;1611;7
"Gennep";17129;8383;340;8746;44,4;43,7;45,1;738;6
"Giessenlanden";14596;7192;224;7404;42,0;41,1;43,0;710;7
"Gilze en Rijen";26220;13088;399;13132;42,5;41,9;43,2;1281;7
"Goeree-Overflakkee";48653;24611;115;24042;43,0;42,1;43,9;2424;6
"Goes";37274;19000;366;18274;44,4;43,2;45,7;1614;7
"Goirle";23317;11774;551;11543;43,4;42,3;44,5;1223;8
"Gooise Meren";56935;29537;734;27398;42,7;41,2;44,1;3102;8
"Gorinchem";35755;18108;1630;17647;41,3;40,2;42,4;1880;6
"Gouda";71752;36548;3962;35204;41,3;40,4;42,1;3947;6
"Grave";12370;6049;441;6321;43,4;42,5;44,3;552;7
"Groningen";202636;101321;2152;101315;37,0;36,5;37,5;8831;7
"Grootegast";12166;5973;139;6193;41,0;40,6;41,5;622;7
"Gulpen-Wittem";14337;7101;195;7236;47,9;47,0;48,9;471;8
"Haaksbergen";24272;12086;230;12186;44,1;43,1;45,0;1031;8
"Haaren";13912;6817;238;7095;44,5;44,1;44,9;519;8
"Haarlem";159229;81198;4962;78031;40,6;39,6;41,7;9364;7
"Haarlemmerliede c.a.";5665;2849;267;2816;42,5;42,0;42,9;277;7
"Haarlemmermeer";146003;73365;789;72638;40,5;39,8;41,1;7128;7
"Halderberge";29579;14892;393;14687;44,5;43,8;45,2;1347;7
"Hardenberg";60211;29753;190;30458;40,7;40,0;41,5;3337;7
"Harderwijk";46352;23439;960;22913;40,5;39,4;41,6;2698;7
"Hardinxveld-Giessendam";17872;8927;924;8945;39,8;38,7;41,0;1122;7
"Haren";19570;10241;386;9329;45,7;44,0;47,2;1022;9
"Harlingen";15860;7867;41;7993;44,0;42,8;45,3;738;7
"Hattem";12040;6109;498;5931;42,8;41,5;44,1;631;7
"Heemskerk";39171;19970;1236;19201;43,6;42,6;44,6;1826;6
"Heemstede";26936;14275;2794;12661;45,7;43,9;47,2;1383;9
"Heerde";18561;9415;231;9146;43,9;43,0;44,7;884;8
"Heerenveen";50203;25306;253;24897;42,9;41,7;44,1;2462;7
"Heerhugowaard";54950;27231;1374;27719;39,9;39,3;40,5;3113;7
"Heerlen";87189;43899;1915;43290;44,9;43,7;46,1;3620;6
"Heeze-Leende";15714;7740;150;7974;44,9;44,0;45,9;697;8
"Heiloo";22857;11548;1202;11309;45,9;44,6;47,3;913;8
"Hellendoorn";35772;17880;257;17892;42,8;41,9;43,7;1663;8
"Hellevoetsluis";38722;19561;837;19161;43,0;42,2;43,7;1770;6
"Helmond";90602;44966;1655;45636;40,5;39,9;41,1;4833;6
"Hendrik-Ido-Ambacht";29731;15082;2498;14649;39,5;38,6;40,3;1969;7
"Hengelo";80802;40327;1307;40475;42,2;41,1;43,2;3881;7
"het Bildt";10493;5158;90;5335;43,0;42,2;43,7;498;6
"Heumen";16475;8316;397;8159;44,7;43,4;45,9;694;8
"Heusden";43516;21716;536;21800;42,6;41,9;43,4;2114;7
"Hillegom";21316;10771;1582;10545;43,2;42,3;44,1;993;6
"Hilvarenbeek";15283;7582;158;7701;43,7;43,0;44,5;641;7
"Hilversum";88888;45277;1918;43611;41,7;40,4;43,0;4777;7
"Hof van Twente";35011;17605;163;17406;44,8;43,7;45,8;1418;8
"Hollands Kroon";47600;23503;72;24097;42,6;42,1;43,1;2248;6
"Hoogeveen";55311;27724;428;27587;42,2;41,1;43,4;2824;6
"Hoogezand-Sappemeer";34232;17326;469;16906;43,8;43,0;44,6;1598;6
"Hoorn";72493;36759;1356;35734;41,1;40,3;41,9;3967;6
"Horst aan de Maas";42139;20929;220;21210;43,2;42,4;44,0;1874;7
"Houten";49300;24962;836;24338;39,3;38,6;40,0;2792;8
"Huizen";41382;21296;1775;20086;43,9;42,5;45,2;1963;7
"Hulst";27395;13745;109;13650;45,9;45,1;46,8;1082;6
"IJsselstein";34208;17556;1578;16652;40,4;39,6;41,3;1735;6
"Kaag en Braassem";26374;13011;365;13363;42,8;42,2;43,5;1288;7
"Kampen";52511;26332;325;26179;39,1;38,2;40,0;3346;8
"Kapelle";12622;6314;254;6308;41,8;40,7;42,8;682;7
"Katwijk";64532;32409;2072;32123;39,8;38,9;40,6;3897;8
"Kerkrade";45937;22969;2074;22968;46,5;45,4;47,6;1822;6
"Koggenland";22522;11182;268;11340;41,8;41,2;42,5;1129;7
"Kollumerland c.a.";12872;6282;111;6590;41,6;41,0;42,2;701;7
"Korendijk";10959;5500;109;5459;42,7;42,3;43,1;576;6
"Krimpen aan den IJssel";29123;15014;3254;14109;43,2;41,8;44,5;1563;7
"Krimpenerwaard";55204;27897;342;27307;42,1;41,5;42,8;2823;7
"Laarbeek";21942;10823;391;11119;43,4;42,7;44,3;959;8
"Landerd";15332;7507;217;7825;42,9;42,4;43,5;738;7
"Landgraaf";37458;19018;1518;18440;46,0;45,1;46,9;1433;7
"Landsmeer";11275;5838;425;5437;43,0;42,5;43,5;611;7
"Langedijk";27608;13899;1021;13709;41,8;41,2;42,3;1408;8
"Lansingerland";60105;30247;1066;29858;38,6;37,9;39,2;4091;8
"Laren";11088;5865;893;5223;48,3;46,2;50,1;455;9
"Leek";19643;9949;306;9694;43,4;42,4;44,4;916;7
"Leerdam";20905;10631;607;10274;41,6;40,5;42,7;1113;6
"Leeuwarden";108667;54836;638;53831;40,4;39,6;41,2;5515;6
"Leeuwarderadeel";10108;5067;244;5041;44,1;43,3;44,8;437;8
"Leiden";123661;63594;5314;60067;38,9;38,6;39,1;5847;7
"Leiderdorp";27128;13989;2209;13139;43,4;42,0;44,8;1381;7
"Leidschendam-Voorburg";74604;38786;2094;35818;43,9;42,5;45,2;4098;7
"Lelystad";76937;38377;101;38560;39,9;39,3;40,5;4358;6
"Leudal";35878;17666;218;18212;45,2;44,2;46,2;1360;7
"Leusden";29677;15083;504;14594;43,0;41,7;44,2;1486;8
"Lingewaal";11158;5587;205;5571;42,0;41,6;42,4;558;7
"Lingewaard";46182;23284;668;22898;42,8;42,0;43,6;2119;7
"Lisse";22717;11539;1415;11178;43,3;42,2;44,4;1088;7
"Littenseradiel";10746;5251;81;5495;41,9;41,2;42,6;550;7
"Lochem";33545;16976;155;16569;46,7;45,5;47,8;1327;8
"Loon op Zand";23093;11632;455;11461;43,8;43,0;44,6;1077;7
"Lopik";14208;7014;180;7194;40,3;39,8;40,9;693;6
"Loppersum";9914;4893;89;5021;43,9;43,3;44,5;449;7
"Losser";22482;11170;226;11312;44,1;43,5;44,7;941;8
"Maasdriel";24250;11950;321;12300;42,1;41,3;43,0;1200;7
"Maasgouw";23774;11829;409;11945;46,8;45,7;47,9;851;8
"Maassluis";32450;16533;3207;15917;43,3;42,5;44,0;1650;6
"Maastricht";122753;63798;2041;58955;42,5;42,0;43,0;4323;6
"Marum";10388;5024;160;5364;42,1;41,2;43,2;500;7
"Medemblik";44058;21631;171;22427;42,3;41,8;42,7;2173;7
"Meerssen";19072;9674;689;9398;46,6;45,7;47,6;705;7
"Meierijstad";79869;39817;431;40052;42,5;41,9;43,1;3933;7
"Menameradiel";13454;6555;192;6899;42,8;41,8;43,9;626;7
"Menterwolde";12162;5981;149;6181;43,7;43,2;44,1;507;7
"Meppel";33025;16888;579;16137;41,9;41,2;42,6;1605;7
"Middelburg";48019;24688;905;23331;42,9;41,7;44,1;2383;7
"Midden-Delfland";19034;9461;385;9573;41,4;40,8;42,0;1015;9
"Midden-Drenthe";33399;16717;97;16682;44,3;43,4;45,2;1439;8
"Mill en Sint Hubert";10807;5287;203;5520;44,0;43,3;44,7;384;6
"Moerdijk";36944;18453;201;18491;43,4;42,5;44,2;1694;6
"Molenwaard";29212;14374;231;14838;39,0;38,1;40,0;1791;7
"Montferland";35316;17631;331;17685;44,7;43,7;45,6;1395;7
"Montfoort";13866;6923;363;6943;40,6;40,1;41,1;774;7
"Mook en Middelaar";7775;3926;413;3849;46,6;45,3;47,9;249;8
"Neder-Betuwe";23303;11637;345;11666;38,7;37,8;39,6;1555;6
"Nederweert";16864;8345;166;8519;44,4;43,7;45,2;724;8
"Neerijnen";12344;6111;169;6233;40,4;39,6;41,1;742;6
"Nieuwegein";61868;31105;2412;30763;42,1;41,2;43,0;3253;6
"Nieuwkoop";27914;13754;306;14160;42,6;41,9;43,2;1343;6
"Nijkerk";41775;20972;580;20803;40,6;39,8;41,3;2482;7
"Nijmegen";173556;89591;3013;83965;39,2;38,7;39,7;8301;6
"Nissewaard";85401;43598;865;41803;42,4;41,4;43,3;4273;6
"Noord-Beveland";7382;3691;61;3691;46,8;46,4;47,2;305;7
"Noordenveld";32981;16808;161;16173;44,6;43,7;45,4;1584;7
"Noordoostpolder";46544;22882;78;23662;40,0;39,1;41,0;2769;6
"Noordwijk";25867;12928;502;12939;43,9;42,9;44,8;1117;7
"Noordwijkerhout";16318;8101;697;8217;43,0;41,8;44,1;747;7
"Nuenen c.a.";22866;11555;674;11311;45,4;44,5;46,3;1032;9
"Nunspeet";26892;13592;208;13300;41,4;40,1;42,5;1557;7
"Nuth";15305;7744;462;7561;46,9;46,2;47,7;579;8
"Oegstgeest";23608;12267;2962;11341;42,4;40,9;43,8;1304;8
"Oirschot";18499;9194;180;9305;43,5;42,7;44,3;838;8
"Oisterwijk";25936;13178;398;12758;44,5;43,4;45,6;1087;8
"Oldambt";38108;19194;129;18914;45,3;44,4;46,1;1552;6
"Oldebroek";23256;11520;235;11736;40,9;40,1;41,8;1297;8
"Oldenzaal";32006;16120;1458;15886;43,1;41,9;44,2;1531;8
"Olst-Wijhe";17957;8886;152;9071;43,2;42,4;44,1;825;8
"Ommen";17531;8676;96;8855;43,0;42,1;43,8;911;7
"Onderbanken";7865;3911;370;3954;45,6;44,5;46,7;301;7
"Oost Gelre";29634;14637;269;14997;43,2;42,1;44,3;1307;7
"Oosterhout";54604;27732;747;26872;43,6;42,8;44,4;2581;7
"Ooststellingwerf";25540;12763;113;12777;44,5;43,4;45,6;1143;6
"Oostzaan";9652;4920;600;4732;42,8;41,8;43,6;483;7
"Opmeer";11420;5628;272;5792;42,5;41,5;43,5;506;7
"Opsterland";29718;14839;131;14879;42,9;42,0;43,9;1328;7
"Oss";90376;45026;529;45350;42,3;41,5;43,1;4376;6
"Oud-Beijerland";24015;12231;1225;11784;42,0;40,8;43,2;1250;6
"Oude IJsselstreek";39568;19702;287;19866;44,3;43,1;45,5;1684;7
"Ouder-Amstel";13419;6865;521;6554;42,9;41,7;44,0;701;7
"Oudewater";10187;5198;254;4989;42,0;41,0;43,0;560;6
"Overbetuwe";47394;23833;412;23561;41,3;40,7;41,9;2583;8
"Papendrecht";32292;16421;2993;15871;42,6;41,6;43,7;1655;6
"Peel en Maas";43347;21348;269;21999;43,7;43,1;44,3;1895;7
"Pekela";12517;6176;249;6341;43,5;42,6;44,4;637;6
"Pijnacker-Nootdorp";52656;26441;1363;26215;38,9;38,3;39,5;3018;8
"Purmerend";79928;40955;3254;38973;42,6;41,4;43,8;3658;6
"Putten";24428;12299;279;12129;41,5;40,6;42,4;1315;7
"Raalte";36907;18358;214;18549;43,4;42,5;44,3;1763;8
"Reimerswaal";22356;11099;92;11257;38,6;38,0;39,2;1568;6
"Renkum";31391;16073;665;15318;46,8;45,3;48,2;1231;8
"Renswoude";5101;2561;276;2540;37,4;37,0;37,8;392;7
"Reusel-De Mierden";12908;6273;164;6635;42,1;41,7;42,4;690;7
"Rheden";43645;22304;517;21341;45,9;44,0;47,6;1776;7
"Rhenen";19597;9944;448;9653;42,0;41,3;42,8;1052;7
"Ridderkerk";45408;23405;1798;22003;44,8;43,5;46,0;2193;6
"Rijnwaarden";10852;5464;226;5388;43,9;43,3;44,4;474;7
"Rijssen-Holten";37983;19042;402;18941;39,5;38,5;40,6;2438;8
"Rijswijk";51027;26703;3522;24324;43,8;42,2;45,3;3024;6
"Roerdalen";20700;10348;233;10352;46,5;45,9;47,2;796;8
"Roermond";57390;29052;808;28338;43,0;42,1;43,9;2743;7
"Roosendaal";77163;39016;720;38147;43,0;42,1;43,9;3844;6
"Rotterdam";634660;321879;1958;312781;39,2;38,3;40,1;37317;4
"Rozendaal";1498;755;54;743;47,4;46,5;48,3;50;9
"Rucphen";22345;11075;347;11270;45,3;44,5;46,1;886;7
"Schagen";46193;23085;247;23108;43,9;42,9;44,8;1887;7
"Scherpenzeel";9704;4894;703;4810;39,6;38,4;40,8;669;7
"Schiedam";77838;39378;3919;38460;40,9;40,0;41,8;4227;5
"Schiermonnikoog";941;458;5;483;48,1;46,8;49,4;29;6
"Schinnen";12954;6486;537;6468;46,2;44,9;47,5;526;8
"Schouwen-Duiveland";33765;17044;69;16721;46,1;45,1;47,2;1416;6
"'s-Hertogenbosch";152411;77135;1291;75276;41,1;40,3;41,9;8219;6
"Simpelveld";10571;5335;659;5236;46,5;45,6;47,3;377;7
"Sint Anthonis";11594;5587;116;6007;43,9;43,1;44,7;483;8
"Sint-Michielsgestel";28584;14212;482;14372;43,4;42,5;44,3;1311;8
"Sittard-Geleen";93319;47314;1158;46005;45,2;44,0;46,3;3695;6
"Sliedrecht";25012;12684;1785;12328;40,9;39,8;42,0;1556;6
"Slochteren";14737;7222;99;7515;43,2;42,6;43,8;668;8
"Sluis";23658;11989;77;11669;47,2;46,0;48,3;946;6
"Smallingerland";55695;27983;441;27712;42,3;41,1;43,5;2802;7
"Soest";45874;23461;988;22413;43,5;42,3;44,7;2164;7
"Someren";19036;9322;234;9714;42,8;41,8;43,9;937;8
"Son en Breugel";16626;8422;627;8204;43,4;42,3;44,5;867;7
"Stadskanaal";32252;16249;269;16003;45,0;43,6;46,3;1414;6
"Staphorst";16691;8142;123;8549;37,1;36,3;37,9;1228;8
"Stede Broec";21552;10715;1317;10837;42,0;41,5;42,6;1152;7
"Steenbergen";23970;11765;151;12205;43,7;42,5;45,0;1023;6
"Steenwijkerland";43448;21661;135;21787;43,3;42,5;44,1;2182;7
"Stein";25059;12634;1099;12425;46,7;45,8;47,6;880;7
"Stichtse Vecht";64450;32901;603;31549;42,3;41,4;43,1;3465;6
"Strijen";8785;4439;152;4346;44,5;43,9;45,1;332;7
"Súdwest-Fryslân";84158;41975;100;42183;42,9;42,1;43,8;4101;7
"Ten Boer";7288;3681;159;3607;42,4;41,0;43,7;388;8
"Terneuzen";54588;27449;172;27139;45,1;44,0;46,1;2482;6
"Terschelling";4859;2280;7;2579;43,5;41,8;45,5;183;4
"Texel";13545;6813;29;6732;45,3;44,6;46,0;549;8
"Teylingen";36093;18077;1078;18016;42,1;41,1;43,1;1704;7
"Tholen";25527;12779;101;12748;40,7;40,0;41,4;1471;6
"Tiel";41488;20843;1168;20645;40,9;40,0;41,8;2058;6
"Tilburg";213804;107376;1794;106428;40,0;39,2;40,7;10672;6
"Tubbergen";21153;10356;143;10797;41,1;40,1;42,2;1015;8
"Twenterand";33845;16699;313;17146;40,4;39,5;41,5;1882;8
"Tynaarlo";33280;16884;225;16396;44,8;43,8;45,8;1744;8
"Tytsjerksteradiel";31963;16002;198;15961;43,4;42,5;44,3;1529;7
"Uden";41384;20867;613;20517;42,6;41,8;43,4;2042;6
"Uitgeest";13465;6704;604;6761;40,8;40,0;41,6;718;6
"Uithoorn";29201;14798;1504;14403;41,8;40,7;42,7;1481;6
"Urk";20220;10028;184;10192;31,5;30,9;32,0;1944;7
"Utrecht";343038;175451;3458;167587;35,5;35,3;35,8;22364;6
"Utrechtse Heuvelrug";49035;25065;366;23970;44,7;43,1;46,2;2255;7
"Vaals";9710;4835;406;4875;48,2;46,7;49,6;317;6
"Valkenburg aan de Geul";16440;8336;445;8104;48,2;47,0;49,4;534;7
"Valkenswaard";30516;15424;540;15092;45,6;44,6;46,6;1263;7
"Veendam";27527;13900;350;13627;43,8;42,7;44,9;1246;6
"Veenendaal";64277;32569;3259;31708;39,9;38,9;41,0;3864;7
"Veere";21900;10882;106;11018;45,3;44,2;46,3;1068;9
"Veldhoven";44724;22439;1401;22285;43,3;42,4;44,2;2172;8
"Velsen";67619;34078;1070;33541;42,9;41,9;43,9;3310;6
"Venlo";101059;50778;783;50281;43,4;42,6;44,3;4631;6
"Venray";43565;21431;264;22134;42,9;42,0;43,7;2004;6
"Vianen";19714;10014;465;9700;42,2;41,2;43,2;1012;6
"Vlaardingen";71999;36852;2698;35147;42,7;41,5;43,9;3971;5
"Vlagtwedde";15908;7969;93;7939;46,1;44,9;47,2;634;6
"Vlieland";1085;552;3;533;44,0;43,5;44,5;31;4
"Vlissingen";44394;22334;129;22060;43,9;42,7;45,1;2022;6
"Voerendaal";12462;6319;395;6143;46,6;45,9;47,4;536;8
"Voorschoten";25315;13141;2190;12174;43,4;42,3;44,5;1378;7
"Voorst";24199;12103;191;12096;44,4;43,5;45,3;1189;8
"Vught";26183;13188;760;12995;43,0;41,7;44,2;1386;8
"Waalre";16898;8579;746;8319;44,5;43,2;45,7;857;8
"Waalwijk";47410;23794;701;23616;43,0;42,0;43,9;2325;6
"Waddinxveen";26536;13344;903;13192;41,9;41,0;42,8;1476;6
"Wageningen";38458;19989;1188;18469;38,7;38,0;39,3;1493;7
"Wassenaar";26055;13742;418;12313;45,3;44,0;46,5;1075;9
"Waterland";17290;8765;149;8525;44,6;44,0;45,2;810;7
"Weert";49574;24734;470;24840;44,1;43,3;45,0;2265;7
"Weesp";18751;9689;859;9062;42,8;42,0;43,5;1007;6
"Werkendam";26844;13383;220;13461;41,4;40,5;42,3;1437;7
"West Maas en Waal";18820;9437;221;9383;43,6;42,8;44,4;821;7
"Westerveld";19084;9586;67;9498;47,1;46,3;47,9;721;8
"Westervoort";14991;7664;1912;7327;42,8;42,0;43,5;696;7
"Westland";105632;52933;1164;52699;41,5;40,7;42,3;5399;6
"Weststellingwerf";25608;12843;112;12765;44,3;43,2;45,5;1185;7
"Westvoorne";14257;7191;146;7066;47,0;45,6;48,4;505;7
"Wierden";24225;12133;254;12092;41,8;41,0;42,7;1336;9
"Wijchen";40876;20656;588;20220;42,7;41,9;43,4;1872;7
"Wijdemeren";23447;12029;307;11418;45,3;44,4;46,1;999;8
"Wijk bij Duurstede";23502;11924;468;11578;42,2;41,4;42,9;1187;7
"Winsum";13596;6892;133;6704;43,4;42,3;44,5;628;7
"Winterswijk";28912;14439;208;14473;44,0;42,9;45,2;1202;7
"Woensdrecht";21837;10874;237;10963;44,6;43,9;45,4;944;7
"Woerden";51513;26031;554;25482;40,8;39,9;41,6;2899;7
"Wormerland";15820;7987;350;7833;44,4;43,6;45,2;603;7
"Woudenberg";12701;6327;345;6374;40,3;38,9;41,7;803;8
"Woudrichem";14539;7255;281;7284;42,2;41,5;43,0;717;7
"Zaanstad";153679;77665;1846;76014;41,1;40,2;42,0;8479;6
"Zaltbommel";27728;13819;311;13909;40,2;39,3;41,1;1611;7
"Zandvoort";16899;8727;384;8172;46,6;45,2;47,8;676;7
"Zederik";13842;6907;181;6935;40,6;39,8;41,4;874;7
"Zeewolde";22457;10908;84;11549;37,9;37,2;38,8;1193;6
"Zeist";62830;32303;1291;30527;42,2;40,7;43,6;3520;7
"Zevenaar";32379;16489;558;15890;44,6;43,5;45,6;1462;7
"Zoetermeer";124763;63840;3367;60923;41,1;40,2;42,0;6848;6
"Zoeterwoude";8367;4221;381;4146;43,2;42,9;43,5;359;8
"Zuidhorn";18859;9432;147;9427;41,3;40,4;42,3;1104;8
"Zuidplas";41468;20886;647;20582;41,2;40,5;42,0;2302;7
"Zundert";21657;10536;179;11121;44,4;43,7;45,1;939;6
"Zutphen";47340;24117;1103;23223;43,0;41,9;44,0;1994;7
"Zwartewaterland";22309;10949;254;11360;38,4;37,6;39,2;1455;7
"Zwijndrecht";44417;22858;1951;21559;43,1;41,7;44,4;2315;6
"Zwolle";125548;63821;1052;61727;39,0;38,2;39,7;7646;7
